Player,Club,POS,GP,GS,A,GWA,HmA,RdA,A/90min
Landon Donovan,LA,M-F,31,30,19,5,11,8,0.63
Robbie Keane,LA,F,29,28,14,6,8,6,0.49
Thierry Henry,NY,F,30,30,14,4,11,3,0.48
Diego Valeri,POR,M,33,32,14,1,10,4,0.46
Obafemi Martins,SEA,F,31,29,13,4,7,6,0.45
Pedro Morales,VAN,M,33,28,12,4,8,4,0.42
Javier Morales,RSL,M,30,30,12,2,7,5,0.41
Cristian Maidana,PHI,M,26,23,11,2,8,3,0.52
Brad Davis,HOU,M,25,25,11,4,7,4,0.48
Marcelo Sarvas,LA,M,28,25,11,4,6,5,0.45
Mauro Rosales,CHV,M,32,26,11,3,5,6,0.42
Clint Dempsey,SEA,F,26,23,10,5,4,6,0.42
Fabian Espindola,DC,F,27,24,9,4,6,3,0.38
Lamar Neagle,SEA,M,32,27,9,0,5,4,0.36
Dillon Powers,ORL,M,30,27,9,1,5,4,0.35
Eric Alexander,HOU,M,34,30,9,2,7,2,0.31
Lloyd Sam,DC,M-F,32,32,9,3,5,4,0.29
Justin Mapp,MTL,M,23,20,8,0,4,4,0.42
Graham Zusi,SKC,D-M,25,24,8,2,4,4,0.33
Shea Salinas,SJ,M,31,30,8,2,5,3,0.29
Stefan Ishizaki,LA,M,30,22,7,3,5,2,0.33
Ethan Finlay,MIN,F,29,21,7,0,2,5,0.33
Luke Mulholland,RSL,M,31,24,7,2,5,2,0.32
Sébastien Le Toux,PHI,F,29,23,7,2,5,2,0.31
Gonzalo Pineda,SEA,M,28,24,7,4,3,4,0.28
Federico Higuain,CLB,M,29,28,7,2,4,3,0.25
Darlington Nagbe,ATL,M,32,30,7,2,4,3,0.23
Chris Rolfe,CHI,F,23,21,6,2,4,2,0.31
Joao Plata,RSL,F,26,24,6,2,4,2,0.27
Blas Pérez,DAL,F,29,24,6,1,2,4,0.26
Waylon Francis,SEA,D,24,24,6,1,3,3,0.26
Harry Shipp,SEA,M,33,26,6,1,4,2,0.23
Teal Bunbury,NE,F,31,28,6,1,3,3,0.22
Felipe,VAN,M,31,28,6,1,4,2,0.22
Benny Feilhaber,LAFC,M,31,30,6,1,3,3,0.21
Tony Tchani,CHI,M,33,33,6,2,2,4,0.18
Hector Jimenez,CLB,M,24,19,5,1,1,4,0.27
Michel Garbini Pereira,DAL,M-D,25,20,5,1,4,1,0.25
Brad Evans,SKC,D-M,26,22,5,1,1,4,0.24
Chris Tierney,NE,D-M,24,21,5,2,3,2,0.23
Marco Pappa,SEA,M,29,24,5,4,3,2,0.23
Gilberto,TOR,F,28,21,5,1,4,1,0.23
Kelyn Rowe,NE,M,27,21,5,2,4,1,0.23
Dominic Oduro,MTL,M,35,23,5,1,1,4,0.21
Dan Gargan,LA,D,29,27,5,1,0,5,0.19
Quincy Amarikwa,SJ,F,32,29,5,0,4,1,0.18
Nick DeLeon,DC,M,32,31,5,0,4,1,0.17
Diego Chara,POR,M,31,31,5,3,2,3,0.16
Lee Nguyen,NE,M,32,32,5,1,2,3,0.16
Giles Barnes,HOU,M,34,34,5,2,3,2,0.15
Jermaine Jones,NE,M,10,7,4,2,3,1,0.59
Kenny Cooper,SEA,F,22,12,4,1,1,3,0.36
Charlie Davies,NE,F,18,13,4,2,2,2,0.31
Fanendo Adi,POR,F,24,18,4,0,3,1,0.24
Mike Magee,CHI,M,17,17,4,1,2,2,0.24
Luis Silva,RSL,F,27,22,4,1,1,3,0.24
Andrés Escobar,DAL,F,23,18,4,1,3,1,0.23
Dillon Serna,COL,M,27,18,4,2,2,2,0.22
Justin Meram,ORL,M,32,19,4,2,2,2,0.21
Jair Benítez,DAL,D,26,19,4,0,3,1,0.21
Marco Di Vaio,MTL,F,26,17,4,1,3,1,0.21
Daigo Kobayashi,NE,M,34,23,4,2,2,2,0.19
Jonathan Osorio,TOR,M,27,24,4,2,2,2,0.18
Ricardo Clark,CLB,M,25,24,4,1,4,0,0.17
Sheanon Williams,PHI,D,24,23,4,3,2,2,0.17
Andrew Wenger,HOU,F,32,22,4,2,2,2,0.17
Diego Fagundez,NE,M,31,25,4,1,3,1,0.17
Luke Moore,CHV,F,33,24,4,0,1,3,0.17
Baggio Husidic,LA,M,34,26,4,0,3,1,0.16
Michael Bradley,TOR,M,25,25,4,1,2,2,0.16
DeAndre Yedlin,USA,D,25,25,4,1,2,2,0.16
Fabian Castillo,DAL,M-F,27,26,4,1,1,3,0.16
Chris Wondolowski,SJ,F,26,26,4,1,3,1,0.15
Wil Trapp,CLB,M,28,28,4,2,4,0,0.14
Sean Franklin,VAN,D,29,28,4,2,2,2,0.14
Juninho,LA,M,34,31,4,1,1,3,0.13
Perry Kitchen,LA,M,31,31,4,1,3,1,0.13
Kofi Sarkodie,HOU,D,32,32,4,2,3,1,0.13
Martin Rivero,CHV,M,7,6,3,0,0,3,0.47
Kevin Alston,NE,D,11,9,3,1,1,2,0.4
Ben Speas,CLB,M-F,13,8,3,0,2,1,0.38
Steve Zakuani,POR,M,17,9,3,0,2,1,0.37
Patrick Nyarko,CHI,F-M,17,9,3,0,0,3,0.32
Kosuke Kimura,NY,D,13,10,3,1,2,1,0.31
Mauro Diaz,DAL,M,17,9,3,1,1,2,0.29
Antonio Dovale,KC,M,19,14,3,0,2,1,0.26
Ambroise Oyongo,NY,D,13,11,3,0,1,2,0.26
Sal Zizzo,ATL,D,19,13,3,0,1,2,0.25
Calum Mallace,LAFC,M,23,12,3,0,1,2,0.24
Omar Cummings,HOU,F,26,14,3,1,3,0,0.21
Dilly Duka,CHI,M,20,15,3,0,3,0,0.2
Chris Korb,DC,D,19,15,3,2,3,0,0.2
Kevin Ellis,KC,D,20,16,3,2,2,1,0.18
Paulo Nagamura,KC,M,21,21,3,0,2,1,0.15
Tesho Akindele,DAL,F,26,18,3,2,2,1,0.15
Darren Mattocks,DC,F,30,20,3,1,2,1,0.15
Patrice Bernier,MTL,M,26,20,3,0,2,1,0.15
Erik Hurtado,VAN,F-M,30,19,3,1,2,1,0.15
Corey Ashe,HOU,M,21,20,3,0,2,1,0.14
Marc Burch,MIN,D,22,21,3,1,2,1,0.14
Roy Miller,POR,D,23,22,3,0,3,0,0.14
Eddie Johnson,DC,F,26,22,3,1,3,0,0.14
Nick Hagglund,TOR,D,25,23,3,0,1,2,0.13
Andres Romero,MTL,M,29,25,3,0,1,2,0.12
Steven Beitashour,LAFC,D,27,27,3,1,2,1,0.11
Vincent Nogueira,PHI,M,29,28,3,0,2,1,0.11
Kyle Beckerman,RSL,M,28,28,3,1,2,1,0.11
Chris Wingert,RSL,D,30,30,3,1,2,1,0.11
Dax McCarty,CHI,M,31,29,3,1,2,1,0.1
Justin Morrow,TOR,D,31,30,3,0,0,3,0.1
Ned Grabavoy,RSL,M,33,30,3,0,2,1,0.1
Chad Marshall,SEA,D,31,31,3,0,1,2,0.1
Jeff Larentowicz,ATL,M,33,33,3,1,2,1,0.09
Bobby Boswell,DC,D,34,34,3,1,2,1,0.09
Sebastian Velasquez,RSL,M,10,1,2,1,1,1,0.81
David Estrada,DC,M-F,10,3,2,0,1,1,0.59
Jonny Steele,NY,M,15,6,2,0,1,1,0.29
Daniel Lovitz,MTL,D,18,5,2,1,2,0,0.29
Grant Ward,CHI,M,23,12,2,1,1,1,0.17
Alvas Powell,POR,D,15,11,2,0,1,1,0.17
Greg Cochrane,CHI,D,12,12,2,0,1,1,0.17
Khari Stephenson,SJ,M,19,11,2,1,1,1,0.17
Taylor Kemp,DC,D,13,12,2,1,2,0,0.17
Yannick Djalo,SJ,M,18,13,2,0,2,0,0.16
Alvaro Saborio,RSL,F,16,13,2,1,0,2,0.16
Maximiliano Urruti,DAL,F,30,12,2,0,1,1,0.15
Kekuta Manneh,VAN,M-F,29,13,2,2,2,0,0.15
Jacob Peterson,KC,F,22,13,2,1,1,1,0.14
Danny Cruz,PHI,M-F,26,16,2,0,2,0,0.13
Robbie Rogers,LA,D,19,15,2,0,1,1,0.13
Luis Gil,RSL,M,26,16,2,1,1,1,0.13
Jack Jewsbury,POR,M,19,16,2,0,2,0,0.13
Conor Casey,PHI,F,25,18,2,1,2,0,0.13
Nigel Reo-Coker,CHV,M,21,17,2,0,1,1,0.12
Tim Cahill,NY,M,23,18,2,0,1,1,0.12
Jermain Defoe,TOR,F,19,17,2,0,0,2,0.12
Scott Caldwell,NE,M,26,14,2,1,0,2,0.12
Gaston Fernandez,POR,M,32,17,2,1,0,2,0.12
Jorge Villafaña,USA,D-M,19,17,2,2,1,1,0.11
Cordell Cato,SJ,F,27,16,2,0,1,1,0.11
Atiba Harris,SJ,D,24,19,2,0,1,1,0.11
Darrius Barnes,NE,D,22,16,2,2,1,1,0.11
Fabinho,PHI,D,19,19,2,0,2,0,0.11
Michael Harrington,POR,D,25,21,2,0,1,1,0.1
Omar Gonzalez,USA,D,22,22,2,0,0,2,0.09
Russell Teibert,VAN,M,29,22,2,0,0,2,0.09
Igor Juliao,KC,D,23,23,2,1,0,2,0.09
Leandro Barrera,CHV,M,32,24,2,0,1,1,0.09
Jack McInerney,MTL,F,30,25,2,0,1,1,0.09
Collen Warner,MIN,M,29,28,2,1,0,2,0.08
José Gonçalves,NE,D,27,27,2,1,2,0,0.08
Gyasi Zardes,CLB,F,32,26,2,0,2,0,0.08
Je-Vaughn Watson,DAL,D,31,29,2,0,2,0,0.07
A.J. DeLaGarza,HOU,D,29,28,2,0,2,0,0.07
Will Johnson,ORL,M,29,29,2,0,2,0,0.07
Bradley Wright-Phillips,RBNY,F,32,29,2,0,1,1,0.07
Seth Sinovic,SKC,D,31,31,2,1,0,2,0.07
Maurice Edu,PHI,M,31,31,2,0,0,2,0.06
Amobi Okugo,PHI,D-M,32,31,2,0,1,1,0.06
Osvaldo Alonso,SEA,M,33,33,2,1,1,1,0.06
Raymon Gaddis,PHI,D,34,34,2,0,1,1,0.06
Bradford Jamieson IV,LA,F,2,0,1,0,0,1,3.91
Samuel Inkoom,GHA,M,2,1,1,0,0,1,1.29
Adolfo Bautista,CHV,F,7,1,1,0,0,1,0.61
Kristopher Tyrpak,CHV,F,9,0,1,0,0,1,0.58
Mark Sherrod,HOU,F,9,3,1,1,1,0,0.4
Brian Brown,PHI,F,8,1,1,0,1,0,0.39
Rob Friend,LA,F,10,4,1,0,0,1,0.24
Matías Pérez García,SJ,F,6,4,1,0,0,1,0.23
Matt Dunn,CHV,M,7,4,1,0,1,0,0.22
Charles Eloundou,COL,F,11,4,1,0,0,1,0.22
Michael Lahoud,PHI,M,8,4,1,1,0,1,0.21
Ignacio Piatti,MTL,M,6,6,1,0,1,0,0.2
Austin Berry,PHI,D,6,6,1,0,1,0,0.18
Matt Miazga,USA,D,7,6,1,0,1,0,0.18
Andy Rose,SEA,M,16,5,1,0,1,0,0.16
Chance Myers,KC,D,7,7,1,0,0,1,0.16
Kalif Alhassan,POR,M,15,5,1,0,1,0,0.15
Devon Sandoval,RSL,F,15,7,1,0,1,0,0.14
Kenny Miller,VAN,F,9,7,1,0,1,0,0.14
Abdoulie Mansally,RSL,D,11,6,1,0,0,1,0.14
Leo Fernandes,PHI,M,13,7,1,1,1,0,0.13
Andrew Jean-Baptiste,CHV,D,10,8,1,0,0,1,0.12
Sanna Nyassi,CHI,M,14,10,1,0,1,0,0.12
Aaron Schoenfeld,CLB,F,15,7,1,1,1,0,0.12
Hendry Thomas,DAL,M,10,9,1,0,1,0,0.12
Kellyn Acosta,DAL,M,15,9,1,0,1,0,0.11
Chad Barrett,SEA,F,26,8,1,1,0,1,0.1
Lewis Neal,DC,M,26,7,1,1,0,1,0.1
Clarence Goodson,SJ,D,10,10,1,0,1,0,0.1
Steven Lenhart,SJ,F,11,10,1,0,0,1,0.1
Soony Saad,KC,F,22,9,1,0,1,0,0.1
Krzysztof Krol,MTL,D,12,11,1,0,0,1,0.09
Marlon Hairston,COL,M,22,9,1,0,1,0,0.09
Rodney Wallace,NYC,F,17,12,1,0,1,0,0.09
Gabriel Torres,PAN,M-F,23,11,1,0,0,1,0.08
Mamadou Danso,MTL,D,13,12,1,0,0,1,0.08
Edson Buddle,COL,F,18,12,1,1,1,0,0.08
Marky Delgado,TOR,M,20,12,1,1,0,1,0.08
Josh Williams,CLB,D,14,13,1,1,0,1,0.08
Bradley Orr,TOR,D,19,14,1,1,1,0,0.08
Jared Watts,COL,D-M,17,13,1,0,0,1,0.08
Alan Gordon,LA,F,29,11,1,0,1,0,0.08
Patrick Mullins,DC,F,21,14,1,0,1,0,0.08
Nathan Sturgis,CHV,M,22,13,1,1,0,1,0.07
Wandrille Lefevre,MTL,D,15,13,1,0,0,1,0.07
Jairo Arrieta,CLB,F,23,14,1,0,0,1,0.07
Andy Dorman,NE,M,16,15,1,0,1,0,0.07
Carlos Alvarez,CHV,M,21,13,1,0,1,0,0.07
Akira Kaji,CHV,D,15,14,1,1,1,0,0.07
Jalil Anibaba,NE,D,16,14,1,0,0,1,0.07
Stephen Keel,DAL,D,16,14,1,1,1,0,0.07
Cristian Fernández Salas,DC,D,15,15,1,0,0,1,0.07
Liam Ridgewell,POR,D,15,15,1,1,0,1,0.07
Peguy Luyindula,NY,F,26,15,1,0,1,0,0.06
Brian Carroll,PHI,M,21,17,1,0,1,0,0.06
Gershon Koffie,VAN,M,21,17,1,0,1,0,0.06
Chris Duvall,MTL,D,19,18,1,0,0,1,0.06
Eric Miller,COL,D,21,18,1,1,1,0,0.05
Bernardo Añor,CLB,M,27,18,1,1,0,1,0.05
Tony Lochhead,CHV,D,20,19,1,1,1,0,0.05
José Mari,COL,M,20,20,1,0,0,1,0.05
Jackson Goncalves,TOR,M,26,21,1,1,1,0,0.05
Lawrence Olum,POR,M-D,25,21,1,0,1,0,0.05
Andrew Driver,HOU,M,34,22,1,0,0,1,0.05
Alex,CHI,M,28,24,1,0,0,1,0.05
Drew Moor,TOR,D,23,23,1,0,0,1,0.05
Matt Watson,CHI,M,27,22,1,0,0,1,0.04
Will Bruin,SEA,F,27,24,1,0,1,0,0.04
Chris Klute,COL,D,25,24,1,0,1,0,0.04
Matt Besler,SKC,D,24,24,1,0,0,1,0.04
Chris Schuler,ORL,D,25,25,1,0,1,0,0.04
Eric Avila,CHV,M,29,26,1,0,1,0,0.04
Boniek Garcia,HOU,M,27,26,1,1,0,1,0.04
Víctor Bernárdez,SJ,D,26,25,1,0,1,0,0.04
Andy O'Brien,VAN,D,26,25,1,0,1,0,0.04
Mark Bloom,TOR,D,26,26,1,1,0,1,0.04
Victor Ulloa,DAL,M,28,26,1,0,1,0,0.04
Hassoun Camara,MTL,D,28,26,1,0,1,0,0.04
Marvell Wynne,COL,D,28,27,1,1,1,0,0.04
Erick Torres,CHV,F,29,29,1,1,0,1,0.04
Jámison Olave,NY,D,28,28,1,1,1,0,0.04
Nick LaBrocca,COL,M,31,29,1,0,0,1,0.03
Jordan Stewart,SJ,D-M,30,29,1,0,1,0,0.03
Lovel Palmer,CHI,D,30,29,1,0,0,1,0.03
David Horst,RSL,D,31,31,1,1,1,0,0.03
Dom Dwyer,ORL,F,33,31,1,1,0,1,0.03
Matias Laba,VAN,M,32,31,1,0,0,1,0.03
Matt Hedges,DAL,D,32,32,1,1,1,0,0.03
A.J. Soares,NE,D,32,32,1,0,1,0,0.03
Conor Shanosky,DC,M-D,0,0,0,0,0,0,0.0
Ryan Richter,TOR,D,0,0,0,0,0,0,0.0
Jonathan Top,DAL,F,0,0,0,0,0,0,0.0
Jack McBean,COL,F,0,0,0,0,0,0,0.0
Orr Barouch,CHI,F,0,0,0,0,0,0,0.0
O'Brian Woodbine,NE,D,0,0,0,0,0,0,0.0
Hunter Jumper,CHI,D,0,0,0,0,0,0,0.0
Bryce Alderson,VAN,M,0,0,0,0,0,0,0.0
London Woodberry,DAL,D,0,0,0,0,0,0,0.0
Tommy Muller,SJ,D,0,0,0,0,0,0,0.0
Ryan Neil,SJ,D,0,0,0,0,0,0,0.0
Alec Sundly,NE,M,0,0,0,0,0,0,0.0
Brian Span,DAL,M,0,0,0,0,0,0,0.0
Caleb Clarke,VAN,F,0,0,0,0,0,0,0.0
Matt Walker,CLB,M,0,0,0,0,0,0,0.0
Jalen Robinson,DC,D,0,0,0,0,0,0,0.0
Matt Wiet,CLB,D,0,0,0,0,0,0,0.0
Victor Munoz,KC,M,0,0,0,0,0,0,0.0
Steven Evans,POR,M,0,0,0,0,0,0,0.0
Christiano François,DC,F,0,0,0,0,0,0,0.0
Schillo Tshuma,POR,F,0,0,0,0,0,0,0.0
Kevin Parsemain,MTQ,F,0,0,0,0,0,0,0.0
Caleb Calvert,COL,F,0,0,0,0,0,0,0.0
Aminu Abdallah,VAN,M,0,0,0,0,0,0,0.0
Damion Lowe,JAM,D,0,0,0,0,0,0,0.0
Manny Aparicio,TOR,M,0,0,0,0,0,0,0.0
Jimmy Ockford,SJ,D,0,0,0,0,0,0,0.0
Ben Sweat,NYC,D,0,0,0,0,0,0,0.0
Aaron Long,RBNY,D,0,0,0,0,0,0,0.0
Benji Lopez,RSL,F,0,0,0,0,0,0,0.0
Fabio Pereira,SEA,M,0,0,0,0,0,0,0.0
Mamadou Diouf,VAN,F,0,0,0,0,0,0,0.0
George Fochive,POR,M,0,0,0,0,0,0,0.0
Michael Kafari,KC,M,0,0,0,0,0,0,0.0
Taylor Peay,RSL,D,0,0,0,0,0,0,0.0
Charlie Rugg,LA,F,0,0,0,0,0,0,0.0
Jossimar Sanchez,NE,D,0,0,0,0,0,0,0.0
Michael Bustamante,NY,M,0,0,0,0,0,0,0.0
Christian Duke,KC,M,0,0,0,0,0,0,0.0
Andre Lewis,VAN,M,0,0,0,0,0,0,0.0
Bryan Salazar,HOU,F,0,0,0,0,0,0,0.0
Zakaria Messoudi,MTL,M,0,0,0,0,0,0,0.0
Andrew Ribeiro,CHV,D,0,0,0,0,0,0,0.0
Anthony Arena,HOU,D,0,0,0,0,0,0,0.0
Brenton Griffiths,COL,D,0,0,0,0,0,0,0.0
Ross Friedman,CLB,D,0,0,0,0,0,0,0.0
Kyle Venter,LA,D,0,0,0,0,0,0,0.0
Marco Franco,CHI,D-M,0,0,0,0,0,0,0.0
Richie Marquez,PHI,D,0,0,0,0,0,0,0.0
Bryan Gallego,POR,D,0,0,0,0,0,0,0.0
Giuseppe Gentile,CHI,F,0,0,0,0,0,0,0.0
Michael Nwiloh,CHV,D,0,0,0,0,0,0,0.0
Gege Soriola,MTL,D,0,0,0,0,0,0,0.0
Justen Glad,RSL,D,0,0,0,0,0,0,0.0
Walter Cabrera,DAL,D,0,0,0,0,0,0,0.0
Chris Mannella,TOR,M,0,0,0,0,0,0,0.0
James Bissue,MTL,M,0,0,0,0,0,0,0.0
Gale Agbossoumonde,COL,D,0,0,0,0,0,0,0.0
Kwame Watson-Siriboe,RSL,D,0,0,0,0,0,0,0.0
Peterson Joseph,KC,M,0,0,0,0,0,0,0.0
George John,DAL,D,0,0,0,0,0,0,0.0
Keon Daniel,PHI,M,0,0,0,0,0,0,0.0
Adrian Lopez,MTL,D,0,0,0,0,0,0,0.0
Nelson Rivas,MTL,D,0,0,0,0,0,0,0.0
Onyekachi Apam,SEA,D,0,0,0,0,0,0,0.0
Carlos Borja,CHV,D,0,0,0,0,0,0,0.0
Lyle Martin,CHV,F,0,0,0,0,0,0,0.0
Nana Attakora,DC,D,0,0,0,0,0,0,0.0
Brian Mullan,COL,D,0,0,0,0,0,0,0.0
Shalrie Joseph,NE,M,0,0,0,0,0,0,0.0
Eric Stevenson,NY,M,1,0,0,0,0,0,0.0
Jordan Hamilton,TOR,F,1,0,0,0,0,0,0.0
Jimmy McLaughlin,PHI,M,1,0,0,0,0,0,0.0
Nicholas Walker,DAL,D,1,0,0,0,0,0,0.0
Coy Craft,DAL,F-M,1,0,0,0,0,0,0.0
Damien Perrinelle,NY,D,2,0,0,0,0,0,0.0
Tony Taylor,NE,F-M,1,0,0,0,0,0,0.0
Jordan Allen,RSL,M-F,2,0,0,0,0,0,0.0
Ian Christianson,NY,M,3,0,0,0,0,0,0.0
Sam Garza,SJ,M,1,0,0,0,0,0,0.0
Connor Lade,RBNY,D,6,0,0,0,0,0,0.0
Daniel Fragoso,CHV,M,2,0,0,0,0,0,0.0
Corben Bone,PHI,M,2,0,0,0,0,0,0.0
Frederic Piquionne,POR,F,3,0,0,0,0,0,0.0
Geoffrey Castillion,NE,F,1,0,0,0,0,0,0.0
Oscar Sorto,LA,D,1,0,0,0,0,0,0.0
Louis Beland-Goyette,MTL,M,1,0,0,0,0,0,0.0
Rafael Garcia,LA,D,1,0,0,0,0,0,0.0
Andre Akpan,NE,F,5,0,0,0,0,0,0.0
Fifi Baiden,CLB,M,1,0,0,0,0,0,0.0
Sean Okoli,SEA,F,3,0,0,0,0,0,0.0
Jose Villarreal,ORL,M,5,0,0,0,0,0,0.0
Bright Dike,TOR,F,2,0,0,0,0,0,0.0
Aaron Kovar,LAFC,M,3,0,0,0,0,0,0.0
Grant Van De Casteele,COL,D,1,0,0,0,0,0,0.0
Cam Weaver,SEA,F,3,0,0,0,0,0,0.0
Dimitry Imbongo,NE,F,2,0,0,0,0,0,0.0
Victor Pineda,CHI,M,4,0,0,0,0,0,0.0
Marius Obekop,NY,M,2,0,0,0,0,0,0.0
Blake Smith,MTL,M,3,0,0,0,0,0,0.0
Romain Gall,CLB,M,3,0,0,0,0,0,0.0
Donnie Smith,NE,M,1,1,0,0,0,0,0.0
Kianz Froese,CAN,M,1,0,0,0,0,0,0.0
Luis Bolanos,CHV,F,3,0,0,0,0,0,0.0
Emanuel Pogatetz,CLB,D,2,0,0,0,0,0,0.0
Davy Armstrong,COL,M,2,0,0,0,0,0,0.0
Raul Mendiola,LA,M,3,0,0,0,0,0,0.0
Michael Seaton,DC,F,2,1,0,0,0,0,0.0
Tristan Bowen,SEA,F,2,0,0,0,0,0,0.0
Chandler Hoffman,LA,F,8,0,0,0,0,0,0.0
Kyle Porter,DC,M,5,0,0,0,0,0,0.0
Martin Steuble,KC,M,3,1,0,0,0,0,0.0
Santiago Gonzalez,MTL,F,9,0,0,0,0,0,0.0
Michael Nanchoff,POR,M,3,1,0,0,0,0,0.0
Josh Gardner,KC,M,1,1,0,0,0,0,0.0
Stephen McCarthy,NE,D,1,1,0,0,0,0,0.0
Andrew Wiedeman,TOR,F,7,0,0,0,0,0,0.0
Mechack Jérôme,KC,D,2,1,0,0,0,0,0.0
Mike Fucito,SJ,F,8,0,0,0,0,0,0.0
Zach Pfeffer,PHI,M,5,1,0,0,0,0,0.0
Christian Dean,CHI,D,4,1,0,0,0,0,0.0
Matthew Fondy,CHI,F,9,0,0,0,0,0,0.0
Jimmy Medranda,SKC,D-M,5,1,0,0,0,0,0.0
Anthony Jackson-Hamel,MTL,F,4,1,0,0,0,0,0.0
Steven Kinney,CHI,D,2,2,0,0,0,0,0.0
Billy Schuler,SJ,F,6,1,0,0,0,0,0.0
Ethen Sampson,VAN,D,2,2,0,0,0,0,0.0
Ike Opara,SKC,D,3,2,0,0,0,0,0.0
Ashtone Morgan,TOR,D,3,2,0,0,0,0,0.0
Robert Earnshaw,CHI,F,5,1,0,0,0,0,0.0
Jeremy Hall,TOR,D-M,3,2,0,0,0,0,0.0
Jason Johnson,HOU,F,8,0,0,0,0,0,0.0
Adam Jahn,CLB,F,4,2,0,0,0,0,0.0
Sam Adekugbe,VAN,D,4,1,0,0,0,0,0.0
Collin Martin,MIN,M,6,2,0,0,0,0,0.0
Alex Caskey,DC,M,11,2,0,0,0,0,0.0
Omar Salgado,VAN,F,8,2,0,0,0,0,0.0
Kevan George,CLB,M,4,2,0,0,0,0,0.0
Antoine Hoppenot,PHI,F,13,1,0,0,0,0,0.0
Danny Mwanga,COL,F,6,2,0,0,0,0,0.0
Daniel Paladini,CLB,M,4,3,0,0,0,0,0.0
Andreas Gorlitz,SJ,D,3,3,0,0,0,0,0.0
Rich Balchan,RSL,D,4,2,0,0,0,0,0.0
Erik Palmer-Brown,KC,D,3,2,0,0,0,0,0.0
Jerry Bengtson,HON,F,7,1,0,0,0,0,0.0
Ruben Bover,NY,M,15,2,0,0,0,0,0.0
Peter Luccin,DAL,M,11,2,0,0,0,0,0.0
Alexander Lopez,HON,M,10,1,0,0,0,0,0.0
James Riley,LA,D,4,3,0,0,0,0,0.0
Sebastian Jaime,RSL,F,6,3,0,0,0,0,0.0
Jeremy Gagnon-Lapare,MTL,M,5,3,0,0,0,0,0.0
John Neeskens,COL,D,5,3,0,0,0,0,0.0
John Stertzer,RSL,M,9,3,0,0,0,0,0.0
Chris Pontius,LA,F,6,3,0,0,0,0,0.0
Danny Garcia,DAL,M-F,4,4,0,0,0,0,0.0
Ryan Hollingshead,DAL,M,11,4,0,0,0,0,0.0
Eric Brunner,HOU,D,6,3,0,0,0,0,0.0
Mehdi Ballouchy,VAN,M,9,3,0,0,0,0,0.0
Agustin Viana,CLB,M-D,4,4,0,0,0,0,0.0
Conor Doyle,DC,F,17,1,0,0,0,0,0.0
Zat Knight,COL,D,4,3,0,0,0,0,0.0
Brian Ownby,HOU,M,19,0,0,0,0,0,0.0
Jared Jeffrey,DC,M,10,2,0,0,0,0,0.0
Kenney Walker,LA,M,8,4,0,0,0,0,0.0
Fred,PHI,M,11,3,0,0,0,0,0.0
Pedro Ribeiro,PHI,M-F,9,3,0,0,0,0,0.0
Tony Cascio,HOU,M,6,4,0,0,0,0,0.0
Samuel,LA,F,8,4,0,0,0,0,0.0
Todd Dunivant,LA,D,7,5,0,0,0,0,0.0
Florent Sinama-Pongolle,CHI,F,7,4,0,0,0,0,0.0
Alex Martinez,KC,M,10,3,0,0,0,0,0.0
Nicolas Mezquida,VAN,M,14,4,0,0,0,0,0.0
Jorge Claros,KC,M,7,4,0,0,0,0,0.0
Claudio Bieler,KC,F,13,4,0,0,0,0,0.0
Gorka Larrea,MTL,M,9,5,0,0,0,0,0.0
Aaron Maund,VAN,D,6,5,0,0,0,0,0.0
Ryan Finley,CHV,F,16,4,0,0,0,0,0.0
Thomas McNamara,NYC,M,6,6,0,0,0,0,0.0
Juan Luis Anangono,CHI,F,15,4,0,0,0,0,0.0
Pablo Pintos,SJ,D,6,6,0,0,0,0,0.0
Mikey Lopez,KC,M,8,5,0,0,0,0,0.0
Saer Sene,NE,M,15,5,0,0,0,0,0.0
Alvaro Rey,CLB,M,9,6,0,0,0,0,0.0
Kofi Opare,DC,D,6,5,0,0,0,0,0.0
Rauwshan McKenzie,POR,D,7,6,0,0,0,0,0.0
Dwayne De Rosario,TOR,M,19,4,0,0,0,0,0.0
Cole Grossman,RSL,M,17,5,0,0,0,0,0.0
Steve Neumann,NE,M-F,23,3,0,0,0,0,0.0
Andrew Jacobson,DAL,M,13,5,0,0,0,0,0.0
Oriol Rosell,ORL,M-D,7,7,0,0,0,0,0.0
Jeb Brovsky,MTL,D,7,7,0,0,0,0,0.0
Micheal Azira,COL,M,14,6,0,0,0,0,0.0
Adam Bedell,CLB,F,16,7,0,0,0,0,0.0
Chris Ritter,CHI,M,10,8,0,0,0,0,0.0
Benji Joya,CHI,M,12,9,0,0,0,0,0.0
Logan Pause,CHI,M,12,6,0,0,0,0,0.0
Tommy Thompson,SJ,M,13,8,0,0,0,0,0.0
Dylan Remick,HOU,D,13,8,0,0,0,0,0.0
Richard Eckersley,NY,D,9,8,0,0,0,0,0.0
Carlos Valdés,PHI,D,8,8,0,0,0,0,0.0
Razvan Cocis,CHI,M,10,8,0,0,0,0,0.0
Carlyle Mitchell,VAN,D,8,8,0,0,0,0,0.0
Ben Zemanski,POR,M,13,7,0,0,0,0,0.0
Marvin Chávez,CHV,M,16,8,0,0,0,0,0.0
Bobby Convey,NY,M,13,9,0,0,0,0,0.0
Aaron Wheeler,PHI,F,15,8,0,0,0,0,0.0
Maxim Tissot,MTL,D,20,7,0,0,0,0,0.0
Robbie Findley,RSL,F,16,8,0,0,0,0,0.0
Chad Barson,CLB,D,13,8,0,0,0,0,0.0
Walker Zimmerman,LAFC,D,10,9,0,0,0,0,0.0
Issey Nakajima-Farran,MTL,M,18,7,0,0,0,0,0.0
Servando Carrasco,LA,M,16,9,0,0,0,0,0.0
Carlos Salcedo,RSL,D,12,8,0,0,0,0,0.0
CJ Sapong,PHI,F,20,7,0,0,0,0,0.0
Kendall Waston,VAN,D,10,9,0,0,0,0,0.0
DaMarcus Beasley,HOU,D,10,10,0,0,0,0,0.0
Karl Ouimette,MTL,D,11,9,0,0,0,0,0.0
David Texeira,DAL,F,19,9,0,0,0,0,0.0
Hernan Bernardello,MTL,M,10,10,0,0,0,0,0.0
Kamani Hill,COL,F,15,11,0,0,0,0,0.0
Brandon Barklage,SJ,D,13,10,0,0,0,0,0.0
Luis Garrido,HON,M,11,11,0,0,0,0,0.0
Jay DeMerit,VAN,D,11,11,0,0,0,0,0.0
Tommy Meyer,LA,D,12,10,0,0,0,0,0.0
JJ Koval,SJ,M,22,9,0,0,0,0,0.0
Danny O'Rourke,POR,D,12,10,0,0,0,0,0.0
Felix Borja,CHV,F,12,12,0,0,0,0,0.0
Vicente Sanchez,COL,F,17,12,0,0,0,0,0.0
Patrick Ianni,CHI,D-M,12,11,0,0,0,0,0.0
Ethan White,PHI,D,12,12,0,0,0,0,0.0
Norberto Paparatto,POR,D,13,12,0,0,0,0,0.0
Moises Hernandez,DAL,D,17,13,0,0,0,0,0.0
Kyle Bekker,TOR,M,20,13,0,0,0,0,0.0
Thomas Piermayr,COL,D,14,14,0,0,0,0,0.0
Adam Moffat,DAL,M,20,13,0,0,0,0,0.0
Djimi Traore,SEA,D,15,13,0,0,0,0,0.0
Jeff Parke,DC,D,13,13,0,0,0,0,0.0
Eric Gehrig,CLB,D,20,14,0,0,0,0,0.0
Olmes Garcia,RSL,F,23,12,0,0,0,0,0.0
Ty Harden,SJ,D,17,13,0,0,0,0,0.0
Eriq Zavaleta,TOR,D,17,15,0,0,0,0,0.0
Armando,NY,M,19,14,0,0,0,0,0.0
AJ Cochran,HOU,D,19,14,0,0,0,0,0.0
Zach Scott,SEA,D,18,16,0,0,0,0,0.0
Johnny Leveron,VAN,D,16,15,0,0,0,0,0.0
Tyson Wahl,CLB,D,18,15,0,0,0,0,0.0
Shaun Francis,SJ,D,20,16,0,0,0,0,0.0
Warren Creavalle,PHI,M,26,17,0,0,0,0,0.0
Giancarlo Gonzalez,CLB,D,17,17,0,0,0,0,0.0
Oswaldo Minda,CHV,M,20,20,0,0,0,0,0.0
Carlos Bocanegra,CHV,D,18,18,0,0,0,0,0.0
Agustín Pelletieri,CHV,M,27,22,0,0,0,0,0.0
Jason Hernandez,SJ,D,20,20,0,0,0,0,0.0
Gonzalo Segares,CHI,D,21,20,0,0,0,0,0.0
Pa-Modou Kah,VAN,D,20,20,0,0,0,0,0.0
Steven Caldwell,TOR,D,21,21,0,0,0,0,0.0
Doneil Henry,VAN,D,21,19,0,0,0,0,0.0
Bobby Burling,CHV,D,22,20,0,0,0,0,0.0
Heath Pearce,MTL,D,23,20,0,0,0,0,0.0
Leonardo González,SEA,D,23,20,0,0,0,0,0.0
Leonardo,HOU,D,24,20,0,0,0,0,0.0
Shane O'Neill,COL,D,21,21,0,0,0,0,0.0
Steve Birnbaum,DC,D,21,21,0,0,0,0,0.0
Ibrahim Sekagya,NY,D,25,23,0,0,0,0,0.0
Sebastian Fernandez,VAN,F,32,24,0,0,0,0,0.0
Jean-Baptiste Pierazzi,SJ,M,24,23,0,0,0,0,0.0
Jermaine Taylor,HOU,D,24,23,0,0,0,0,0.0
Jhon Kennedy Hurtado,CHI,D,25,24,0,0,0,0,0.0
Aurélien Collin,RBNY,D,26,25,0,0,0,0,0.0
Matteo Ferrari,MTL,D,25,25,0,0,0,0,0.0
Donny Toia,ORL,D,27,24,0,0,0,0,0.0
Bakary Soumare,CHI,D,26,25,0,0,0,0,0.0
Deshorn Brown,COL,F,30,26,0,0,0,0,0.0
Zach Loyd,DAL,D,29,28,0,0,0,0,0.0
Tony Beltran,RSL,D,29,28,0,0,0,0,0.0
Davy Arnaud,DC,M,31,30,0,0,0,0,0.0
Sam Cronin,MIN,M,31,30,0,0,0,0,0.0
Michael Parkhurst,ATL,D,33,32,0,0,0,0,0.0
Andrew Farrell,NE,D,32,32,0,0,0,0,0.0
Nat Borchers,RSL,D,32,32,0,0,0,0,0.0
Jordan Harvey,LAFC,D,33,33,0,0,0,0,0.0
Stats Unavailable,nan,nan,nan,nan,nan,nan,nan,nan,nan
