Player,Club,POS,GP,GS,A,GWA,HmA,RdA,A/90min
Carlos Valderrama,TB,M,32,32,26,6,16,10,0.81
Steve Ralston,TB,M,30,30,17,8,12,5,0.58
Martin Machon,MIA,M,24,21,16,5,8,8,0.74
Preki,KC,M,31,29,15,4,12,3,0.54
Peter Nowak,CHI,M,28,28,14,3,9,5,0.52
Clint Mathis,LA,M,29,28,14,3,6,8,0.5
Diego Gutierrez,CHI,D,24,23,13,4,8,5,0.6
Jason Kreis,DAL,M,27,27,13,4,9,4,0.49
Robert Warzycha,CLB,M,30,29,13,3,10,3,0.44
Eric Quill,TB,F,30,25,11,2,6,5,0.45
Mark Chung,MET,M,30,28,11,5,8,3,0.39
Matt McKeon,KC,D,30,30,11,5,7,4,0.38
Diego Serna,MIA,F,31,25,10,3,5,5,0.4
Oscar Pareja,DAL,M,29,27,10,4,4,6,0.38
Anders Limpar,COL,M,18,12,9,5,4,5,0.73
Roy Lassiter,MIA,F,27,20,9,2,5,4,0.44
Chad Deering,DAL,M,29,24,9,2,9,0,0.37
Adolfo Valencia,MET,F,31,25,9,2,6,3,0.35
Dante Washington,CLB,F,30,28,9,1,6,3,0.32
Richard Mulrooney,SJ,M,29,29,9,3,7,2,0.31
Chris Henderson,KC,M,31,30,9,5,5,4,0.3
Dominic Kinnear,TB,M,23,12,8,3,7,1,0.56
Mauricio Ramos,NE,M,21,21,8,4,4,4,0.43
Jeff Cunningham,CLB,F,29,16,8,3,6,2,0.41
Marco Etcheverry,DC,M,22,20,8,1,4,4,0.4
Henry Gutierrez,MIA,M,27,23,8,2,5,3,0.36
Chris Klein,KC,M,27,26,8,4,4,4,0.33
Imad Baba,NE,M,30,29,8,3,7,1,0.29
Jesse Marsch,CHI,M,30,29,8,2,4,4,0.27
Hristo Stoitchkov,CHI,F,18,12,7,1,5,2,0.64
Paul Broome,DAL,M,20,12,7,1,5,2,0.57
Evan Whitfield,CHI,D,25,11,7,3,3,4,0.49
Welton,MIA,F,26,14,7,1,2,5,0.46
Manny Lagos,TB,M,27,17,7,2,3,4,0.42
Roy Myers,LA,M-F,25,19,7,1,4,3,0.37
Maurice Johnston,KC,M-F,25,22,7,3,5,2,0.32
Junior Agogo,CHI,F,23,22,7,1,1,6,0.32
Jaime Moreno,DC,F,25,25,7,2,3,4,0.28
Mauricio Cienfuegos,LA,M,28,28,7,1,2,5,0.24
Wolde Harris,NE,F,31,31,7,1,5,2,0.24
Josh Keller,TB,M,31,31,7,2,4,3,0.23
Lubos Kubik,CHI,D,13,12,6,2,1,5,0.55
Matt Okoh,COL,F,21,12,6,2,3,3,0.52
Bobby Rhine,DAL,M,23,17,6,3,3,3,0.39
Luis Hernandez,LA,F,16,15,6,3,1,5,0.38
Alex Comas,MET,M,25,17,6,0,1,5,0.34
Tab Ramos,MET,M,20,18,6,2,4,2,0.33
Sasha Victorine,LA,M,26,21,6,2,1,5,0.28
Jorge Rodriguez,DAL,M-D,25,22,6,1,4,2,0.26
Ante Razov,CHI,F,24,24,6,2,3,3,0.25
Brian West,CLB,M-F,28,24,6,3,5,1,0.24
Cobi Jones,LA,M,25,25,6,2,2,4,0.24
Petter Villegas,MET,M,29,27,6,1,1,5,0.23
John Harkes,NE,M,28,27,6,1,3,3,0.22
Jay Heaps,MIA,D,29,29,6,0,5,1,0.21
Lazo Alavanja,DAL,M,24,15,5,1,3,2,0.31
Chris Armas,CHI,M,16,16,5,1,2,3,0.3
Brian McBride,CLB,F,18,17,5,1,2,3,0.3
Josh Wolff,CHI,F,25,20,5,2,3,2,0.23
Jason Moore,COL,M,27,27,5,3,2,3,0.19
Dema Kovalenko,CHI,M,31,28,5,1,2,3,0.19
Marcelo Balboa,COL,D,28,28,5,1,3,2,0.18
Simon Elliott,LA,M,28,27,5,1,2,3,0.18
Henry Zambrano,COL,F,18,13,4,1,2,2,0.33
Andy Williams,MIA,M,20,14,4,0,4,0,0.28
Johnny Torres,NE,F,20,14,4,1,3,1,0.27
Zak Ibsen,LA,M,27,15,4,1,1,3,0.24
Khodadad Azizi,SJ,F,20,18,4,0,2,2,0.23
Mark Santel,DAL,M,25,18,4,2,4,0,0.21
Chad McCarty,TB,D,22,22,4,0,4,0,0.2
Geoff Aunger,DC,D,26,22,4,1,1,3,0.17
Dario Brose,SJ,M,28,21,4,1,4,0,0.17
Paul Caligiuri,LA,D,28,24,4,1,1,3,0.16
Mamadou Diallo,TB,F,28,26,4,0,3,1,0.15
Jim Rooney,MIA,M,30,27,4,0,4,0,0.15
Antonio Martinez,DAL,F-M,15,3,3,0,3,0,0.51
Joey DiGiamarino,COL,M,18,6,3,1,1,2,0.33
Jamar Beasley,NE,M,19,6,3,1,2,1,0.32
Nelson Vargas,MIA,M,14,10,3,2,2,1,0.3
Ben Olsen,DC,M,13,13,3,0,2,1,0.26
Aleksey Korol,DAL,F,21,11,3,0,3,0,0.26
Mike Sorber,CHI,M,19,13,3,1,3,0,0.25
A.J. Wood,DC,F,24,12,3,0,1,2,0.22
William Sunsing,NE,F,26,9,3,2,3,0,0.21
Lothar Matthaus,MET,D,16,16,3,1,1,2,0.2
Paul Dougherty,COL,F,24,19,3,1,0,3,0.17
Ezra Hendrickson,LA,D,22,20,3,2,2,1,0.14
Ian Russell,SJ,D,28,20,3,0,2,1,0.14
Brian Kamler,MIA,M,28,20,3,1,2,1,0.14
Paul Bravo,COL,M,27,24,3,1,2,1,0.13
Jeff Agoos,DC,D,23,23,3,1,2,1,0.13
Ariel Graziani,DAL,F,24,24,3,2,2,1,0.13
Abdul Thompson Conteh,SJ,F,31,27,3,1,3,0,0.11
Mike Clark,CLB,D,28,28,3,0,1,2,0.11
David Vaudreuil,COL,D,28,28,3,0,1,2,0.11
John Wilmar Perez,CLB,M,30,30,3,1,2,1,0.1
Ritchie Kotschau,TB,D,32,29,3,1,2,1,0.1
Kerry Zavagnin,KC,M,31,31,3,1,3,0,0.1
Peter Vermes,KC,D,32,32,3,1,0,3,0.09
Peter Byaruhanga,KC,F,6,2,2,1,0,2,1.06
Gary Glasgow,KC,F,11,5,2,0,0,2,0.38
Jamie Clark,SJ,D,8,5,2,0,1,1,0.36
Brian Johnson,KC,M,18,4,2,0,1,1,0.31
Eric Wynalda,MIA,F,11,6,2,0,1,1,0.28
Kevin Anderson,COL,M-D,21,9,2,0,1,1,0.2
DaMarcus Beasley,HOU,D,18,11,2,1,1,1,0.17
Mike Duhaney,CLB,D,20,14,2,0,2,0,0.15
Jason Farrell,CLB,F,24,13,2,1,0,2,0.14
Thomas Dooley,MET,D,20,17,2,0,1,1,0.14
Sergi Daniv,DAL,M,18,16,2,1,1,1,0.14
Daniel Hernandez,MET,M,17,15,2,2,0,2,0.13
Ramiro Corrales,MET,M,22,15,2,0,1,1,0.12
John Maessner,DC,M-D,24,17,2,1,0,2,0.12
Bobby Convey,DC,M,22,18,2,0,2,0,0.11
Ricardo Iribarren,DAL,D,22,21,2,0,2,0,0.11
Ansil Elcock,CLB,D,19,18,2,0,2,0,0.11
Eddie Pope,DC,D,21,21,2,1,1,1,0.1
Harut Karapetyan,SJ,F,24,22,2,0,2,0,0.1
John Doyle,SJ,D,20,20,2,1,1,1,0.1
Tyrone Marshall,MIA,D,23,21,2,1,1,1,0.1
Raul Diaz Arce,DC,F,23,21,2,0,2,0,0.1
Jason Bent,COL,M,21,21,2,1,1,1,0.09
Ted Eck,DAL,M-F,29,22,2,1,1,1,0.09
Mike Burns,NE,M,26,20,2,1,2,0,0.09
Ted Chronopoulos,NE,D,25,25,2,0,0,2,0.08
Jimmy Conrad,SJ,D,26,25,2,0,2,0,0.08
Richie Williams,DC,M,29,27,2,1,2,0,0.07
Leonel Alvarez,NE,M,28,28,2,1,1,1,0.07
Steve Jolley,LA,D,28,27,2,0,1,1,0.07
Greg Vanney,LA,D,27,27,2,2,1,1,0.07
Joe Franchino,LA,M,30,29,2,0,1,1,0.07
Chris Martinez,COL,D,30,30,2,0,2,0,0.07
Eric Dade,DAL,D,31,30,2,0,1,1,0.07
Rob Smith,CLB,M,1,1,1,0,0,1,2.31
Paul Keegan,NE,F,11,0,1,0,1,0,1.08
Micah Cooks,DC,M-D,5,2,1,0,1,0,0.55
Shaker Asad,NE,M,8,2,1,0,0,1,0.37
Giovanni Savarese,SJ,F,4,4,1,0,1,0,0.3
Vicente Figueroa,KC,D,8,3,1,0,1,0,0.28
Roland Aguilera,CLB,M,16,3,1,0,1,0,0.2
John Wolyniec,CHI,F,15,1,1,0,1,0,0.2
Jeff Bilyk,MIA,M,9,7,1,0,0,1,0.15
Travis Mulraine,SJ,M,15,7,1,0,0,1,0.14
Judah Cooks,DC,M,15,7,1,0,1,0,0.14
Francisco Gomez,KC,M,14,7,1,0,0,1,0.13
Ross Paule,COL,M,16,6,1,0,0,1,0.11
Ronald Cerritos,SJ,F,9,9,1,0,1,0,0.11
Kalin Bankov,TB,M,18,9,1,0,1,0,0.1
Miles Joseph,CLB,M,23,10,1,0,1,0,0.1
Antonio Otero,DC,M,13,10,1,0,0,1,0.09
Justin Evans,CHI,M,15,11,1,1,1,0,0.09
Peter Vagenas,LA,M,16,12,1,1,1,0,0.09
Eric Denton,DC,D,16,12,1,0,0,1,0.08
Chris Brown,KC,M-F,22,10,1,0,0,1,0.08
Jorge Dely Valdes,COL,F,20,13,1,1,1,0,0.07
Miklos Molnar,KC,F,17,16,1,0,1,0,0.07
Steve Shak,MET,D,23,14,1,0,0,1,0.06
John DeBrito,CLB,D,20,17,1,0,1,0,0.06
Danny Califf,LA,D,18,16,1,0,0,1,0.06
Mauricio Solis,SJ,M,18,17,1,0,1,0,0.06
Dan Calichman,NE,D,20,20,1,1,0,1,0.05
Billy Walsh,MET,M,24,19,1,1,0,1,0.05
Ivan McKinley,MIA,D-M,23,22,1,0,0,1,0.05
Mike Lapper,CLB,D,24,20,1,1,1,0,0.05
Lance Key,COL,D,21,21,1,1,1,0,0.05
Leo Cullen,MIA,M,22,22,1,0,1,0,0.05
Carlos Llamosa,DC,D,23,20,1,0,0,1,0.05
Ryan Tinsley,SJ,D,25,23,1,1,0,1,0.04
Richard Farrer,DAL,D,28,20,1,0,1,0,0.04
Scott Vermillion,COL,D,28,25,1,0,0,1,0.04
Carlos Bocanegra,CHI,D,27,27,1,0,1,0,0.04
Mauricio Wright,NE,D,26,26,1,0,0,1,0.04
Carey Talley,DC,D,29,28,1,0,0,1,0.04
C.J. Brown,CHI,D,27,27,1,1,0,1,0.04
Pablo Mastroeni,MIA,M,29,29,1,0,1,0,0.03
Mike Petke,MET,D,30,29,1,0,1,0,0.03
Steve Trittschuh,TB,D,32,32,1,1,0,1,0.03
Joseph Addo,TB,D,32,32,1,0,1,0,0.03
Alijohn Utush,COL,D,0,0,0,0,0,0,0.0
Tim Weaver,SJ,D,0,0,0,0,0,0,0.0
Christoff Lindenmayer,CLB,M-F,0,0,0,0,0,0,0.0
Mario Longo,CLB,M,0,0,0,0,0,0,0.0
O'Neil Peart,MET,F,0,0,0,0,0,0,0.0
Clint Peay,DC,D,0,0,0,0,0,0,0.0
Michael Green,KC,D,0,0,0,0,0,0,0.0
Ernest Inneh,TB,F,0,0,0,0,0,0,0.0
Gerard Lagos,TB,F,0,0,0,0,0,0,0.0
Steve Bernal,DAL,D,0,0,0,0,0,0,0.0
Ubusuku Abukusumo,TB,D,0,0,0,0,0,0,0.0
Alan Woods,COL,D,1,0,0,0,0,0,0.0
Keith Beach,MIA,M,1,0,0,0,0,0,0.0
Ryan Edwards,SJ,F,1,0,0,0,0,0,0.0
Sheldon Thomas,LA,F,1,0,0,0,0,0,0.0
Sergio Salas,DC,F,1,0,0,0,0,0,0.0
Angel Rivillo,DAL,M-F,1,0,0,0,0,0,0.0
Seth Trembly,COL,M-D,4,0,0,0,0,0,0.0
Brian Haynes,DAL,M,1,0,0,0,0,0,0.0
Nino Da Silva,MET,F,3,0,0,0,0,0,0.0
Mike Slivinski,DC,M,2,0,0,0,0,0,0.0
Fabio Zuniga,NE,F,1,1,0,0,0,0,0.0
Julian Gomez,MET,M,3,0,0,0,0,0,0.0
Kirk Wilson,DAL,M,1,1,0,0,0,0,0.0
Amos Magee,TB,F,7,0,0,0,0,0,0.0
Yuri Lavrinenko,CHI,M,3,1,0,0,0,0,0.0
Chris Houser,TB,D,3,0,0,0,0,0,0.0
Craig Waibel,COL,D,2,0,0,0,0,0,0.0
Ihor Dotsenko,KC,F,2,2,0,0,0,0,0.0
Maurizio Rocha,MIA,M,2,1,0,0,0,0,0.0
Tenywa Bonseu,CHI,D,2,1,0,0,0,0,0.0
John Wilson,KC,D,3,1,0,0,0,0,0.0
Kyle Beckerman,RSL,M,2,1,0,0,0,0,0.0
Danny DeVall,COL,M,2,1,0,0,0,0,0.0
Gabe Eastman,SJ,D,2,1,0,0,0,0,0.0
Dominic Schell,CLB,M-D,7,1,0,0,0,0,0.0
Manuel Bucuane,TB,F,6,1,0,0,0,0,0.0
Jeremy Aldrich,MIA,D,4,1,0,0,0,0,0.0
Eduardo Hurtado,NE,F,3,1,0,0,0,0,0.0
Wade Barrett,SJ,D,3,2,0,0,0,0,0.0
Matt Chulis,CLB,D,6,2,0,0,0,0,0.0
Tahj Jakins,COL,D,3,2,0,0,0,0,0.0
Chris Jahr,CHI,D,2,2,0,0,0,0,0.0
Marvin Quijano,LA,F,5,1,0,0,0,0,0.0
Jeff DiMaria,COL,F,4,2,0,0,0,0,0.0
Dahir Mohammed,MET,D,3,1,0,0,0,0,0.0
Ray Goodlett,DC,D,4,3,0,0,0,0,0.0
Adam Frye,LA,D,6,3,0,0,0,0,0.0
Jorge Salcedo,LA,M,5,3,0,0,0,0,0.0
Alex Bunbury,KC,F,5,3,0,0,0,0,0.0
Esmundo Rodriguez,DAL,M,8,2,0,0,0,0,0.0
Steve Armas,CLB,M,4,4,0,0,0,0,0.0
Sam George,CHI,M,16,3,0,0,0,0,0.0
Mike Burke,DAL,F,9,4,0,0,0,0,0.0
Miroslaw Rzepa,CLB,M-D,5,4,0,0,0,0,0.0
Ivan Polic,LA,M,12,4,0,0,0,0,0.0
Mohammad Khakpour,MET,D,5,5,0,0,0,0,0.0
Uche Okafor,KC,D,14,2,0,0,0,0,0.0
David Hayes,DC,F,10,4,0,0,0,0,0.0
Carlos Parra,NE,M,14,4,0,0,0,0,0.0
Jose Luis Morales,NE,F,8,6,0,0,0,0,0.0
Seth George,LA,F,14,5,0,0,0,0,0.0
Wes Hart,COL,D-M,7,4,0,0,0,0,0.0
Scott Bower,SJ,M,12,5,0,0,0,0,0.0
Orlando Perez,MET,D,15,4,0,0,0,0,0.0
Keyeno Thomas,COL,M-D,12,5,0,0,0,0,0.0
Pete Marino,DC,F,15,5,0,0,0,0,0.0
Brian Kelly,LA,M,18,6,0,0,0,0,0.0
Tim Sahaydak,MIA,D,9,7,0,0,0,0,0.0
Mark Semioli,MET,D,16,7,0,0,0,0,0.0
Adam Eyre,NE,D,10,8,0,0,0,0,0.0
Brandon Pollard,DAL,D,15,9,0,0,0,0,0.0
Sebastien Vorbe,LA,M,19,10,0,0,0,0,0.0
Tom Soehn,CHI,D,19,11,0,0,0,0,0.0
Francis Okaroh,MIA,D,13,13,0,0,0,0,0.0
Danny Pena,LA,D,14,14,0,0,0,0,0.0
Wojtek Krakowiak,SJ,M,24,11,0,0,0,0,0.0
Andrew Lewis,CHI,M,19,17,0,0,0,0,0.0
Mario Gori,CLB,D,25,19,0,0,0,0,0.0
Chris Albright,DC,D,25,21,0,0,0,0,0.0
Brian Dunseth,NE,D,22,22,0,0,0,0,0.0
Todd Yeagley,CLB,M,25,24,0,0,0,0,0.0
Robin Fraser,LA,D,25,24,0,0,0,0,0.0
Rusty Pierce,NE,D,29,29,0,0,0,0,0.0
Brandon Prideaux,KC,D,31,31,0,0,0,0,0.0
Nick Garcia,KC,D,32,32,0,0,0,0,0.0
Stats Unavailable,nan,nan,nan,nan,nan,nan,nan,nan,nan
